1111111
1P000N1
1000001
1000001
1000001
1C000E1
1111111